R 500 500
NO	./.textures/1.xpm
SO	./.textures/2.xpm
EA	./.textures/5.xpm
WE	./.textures/4.xpm
S	./.textures/6.xpm
C	10,10,10
F	45,45,45






                                     111111111111
                                     100000000001
111111111111111111111111111          100000000201
100000000000000000000000001          100000000001
1N0000000000002000000000001          100002000001
100000000000000000000000001          100000200001
111111111111111111111000001          100000000001
                    1000001          100000000001
                    10000011111111111100000000001111111111111
                    10002000000000000000000000000000000000001
                    10000000000000000000000000000000000000001
                    10111111111200000011121111111111121111101
                    10101010101200000010121010101010121010101
                    10000000000000000000000000000000000000001
                    10000000000000000000000000000000000000001
                    10000000000000000000000000000000000000001
                    10000000000001111111111111100000000000001
                    10000000000000000000000000000000000000001
                    10000000000000000000000000000000000000001
                    10000000000000000000000000000000000000001
                    11111111111111111111111111111111111111111
