R 1200 900

NO	./.textures/1.xpm
SO	./.textures/2.xpm
EA	./.textures/5.xpm
WE	./.textures/4.xpm
S	./.textures/6.xpm

C	0,0,0
F	255,0,0

11111111111111111111111111111111111111
10000000000000000000000000000000000001
1000000000000000000000000S000000000001
10000000000000000000000000000000000001
10000000000000000000000000000000000001
11111111111111000000000000000000000001
             10000000000000000000000011111111
             10000000000000000000000000000001
             10000000000000000000000000000001
             10000000000000000000000011111111
11111111111111000000000000000000000001
10000000000000000000000000000000000001
10000000000000000000000000000000000001
10000000000000000000000000000000000001
10000000000000000000000000000000000001
11111111111111111111111111111111111111
