R 790000 70
NO	./.textures/1.xpm
SO	./.textures/2.xpm
EA	./.textures/5.xpm
WE	./.textures/4.xpm
S	./.textures/6.xpm
C	0,0,0
F	255,0,0

1111111111111111111111111111111111111111111111111111111111111111111111111111111111111111111111111111111111111111111111111111111111111111111111111111111111111111111111111111111111111111111111111111111111111111111111111111
10000000000000000000000000000000000000000000000000000000000000000000000000000000000000000000000000000000000000000000000000000000000000000000000000000000000000000000000000000000000000000000000000000000000000000000000111111111111
10000000000000000000000000000000000000000000000000000000000000000000000000000000000000000000000000000000000000000000000000000000000000000000000000000000000000000000000000000000000000000000000000000000000000000000000111111111111
10000000000000000000000000000000000000000000000000000000000000000000000000000000000000000000000000000000000000000000000000000000000000000000000000000000000000000000000000000000000000000000000000000000000000000000000111111111111
10000000000000000000000000000000000000000000000000000000000000000000000000000000000000000000000000000000000000000000000000000000000000000000000000000000000000000000000000000000000000000000000000000000000000000000000111111111111
10000000000000000000000000000000000000000000000000000000000000000000000000000000000000000000000000000000000000000000000000000000000000000000000000000000000000000000000000000000000000000000000000000000000000000000000111111111111
10000000000000000000000000000000000000000000000000000000000000000000000000000000000000000000000000000000000000000000000000000000000000000000000000000000000000000000000000000000000000000000000000000000000000000000000111111111111
10000000000000000000000000000000000000000000000000000000000000000000000000000000000000000000000000000000000000000000000000000000000000000000000000000000000000000000000000000000000000000000000000000000000000000000000111111111111
10000000000000000000000000000000000000000000000000000000000000000000000000000000000000000000000000000000000000000000000000000000000000000000000000000000000000000000000000000000000000000000000000000000000000000000000111111111111
10000000000000000000000000000000000000000000000000000000000000000000000000000000000000000000000000000000000000000000000000000000000000000000000000000000000000000000000000000000000000000000000000000000000000000000000111111111111
10000000000000000000000000000000000000000000000000000000000000000000000000000000000000000000000000000000000000000000000000000000000000000000000000000000000000000000000000000000000000000000000000000000000000000000000111111111111
10000000000000000000000000000000000000000000000000000000000000000000000000000000000000000000000000000000000000000000000000000000000000000000000000000000000000000000000000000000000000000000000000000000000000000000000111111111111
10000000000000000000000000000000000000000000000000000000000000000000000000000000000000000000000000000000000000000000000000000000000000000000000000000000000000000000000000000000000000000000000000000000000000000000000111111111111
10000000000000000000000000000000000000000000000000000000000000000000000000000000000000000000000000000000000000000000000000000000000000000000000000000000000000000000000000000000000000000000000000000000000000000000000111111111111
10000000000000000000000000000000000000000000000000000000000000000000000000000000000000000000000000000000000011111111111111111111111111111111111111111111111111111111111111111111111111111111111111111111111111111111111111111
100000000000000000000000000000000000000000000000000000000000000000000000000000000000000000000000000000000000111111111111
100000000000000000000000000000000000000000000000000000000000000000000000000000000000000000000000000000000000111111111111
100000000000000000000000000000000000000000000000000000000000000000000000000000000000000000000000000000000000111111111111
100000000000000000000000000000000000000000000000000000000000000000000000000000000000000000000000000000000000111111111111
100000000000000000000000000000000000000000000000000000000000000000000000000000000000000000000000000000000000111111111111
100000000000000000000000000000000000000000000000000000000000000000000000000000000000000000000000000000000000111111111111
100000000000000000000000000000000000000000000000000000000000000000000000000000000000000000000000000000000000111111111111
100000000000000000000000000000000000000000000000000000000000000000000000000000000000000000000000000000000000111111111111
100000000000000000000000000000000000000000000000000000000000000000000000000000000000000000000000000000000000111111111111
100000000000000000000000000000000000000000000000000000000000000000000000000000000000000000000000000000000000111111111111
100000000000000000000000000000000000000000000000000000000000000000000000000000000000000000000000000000000000111111111111
100000000000000000000000000000000000000000000000000000000000000000000000000000000000000000000000000000000000111111111111
100000000000000000000000000000000000000000000000000000000000000000000000000000000000000000000000000000000000111111111111
100000000000000000000000000000000000000000000000000000000000000000000000000000000000000000000000000000000000111111111111
100000000000000000000000000000000000000000000000000000000000000000000000000000000000000000000000000000000000111111111111
100000000000000000000000000000000000000000000000000000000000000000000000000000000000000000000000000000000000111111111111
100000000000000000000000000000000000000000000000000000000000000000000000000000000000000000000000000000000000111111111111
100000000000000000000000000000000000000000000000000000000000000000000000000000000000000000000000000000000000111111111111
100000000000000000000000000000000000000000000000000000000000000000000000000000000000000000000000000000000000111111111111
100000000000000000000000000000000000000000000000000000000000000000000000000000000000000000000000000000000000111111111111
100000000000000000000000000000000000000000000000000000000000000000000000000000000000000000000000000000000000111111111111
100000000000000000000000000000000000000000000000000000000000000000000000000000000000000000000000000000000000111111111111
100000000000000000000000000000000000000000000000000000000000000000000000000000000000000000000000000000000000111111111111
100000000000000000000000000000000000000000000000000000000000000000000000000000000000000000000000000000000000111111111111
100000000000000000000000000000000000000000000000000000000000000000000000000000000000000000000000000000000000111111111111
100000000000000000000000000000000000000000000000000000000000000000000000000000000000000000000000000000000000111111111111
100000000000000000000000000000000000000000000000000000000000000000000000000000000000000000000000000000000000111111111111
100000000000000000000000000000000000000000000000000000000000000000000000000000000000000000000000000000000000111111111111
100000000000000000000000000000000000000000000000000000000000000000000000000000000000000000000000000000000000111111111111
100000000000000000000000000000000000000000000000000000000000000000000000000000000000000000000000000000000000111111111111
100000000000000000000000000000000000000000000000000000000000000000000000000000000000000000000000000000000000111111111111
100000000000000000000000000000000000000000000000000000000000000000000000000000000000000000000000000000000000111111111111
100000000000000000000000000000000000000000000000000000000000000000000000000000000000000000000000000000000000111111111111
100000000000000000000000000000000000000000000000000000000000000000000000000000000000000000000000000000000000111111111111
100000000000000000000000000000000000000000000000000000000000000000000000000000000000000000000000000000000000111111111111
100000000000000000000000000000000000000000000000000000000000000000000000000000000000000000000000000000000000111111111111
100000000000000000000000000000000000000000000000000000000000000000000000000000000000000000000000000000000000111111111111
100000000000000000000000000000000000000000000000000000000000000000000000000000000000000000000000000000000000111111111111
100000000000000000000000000000000000000000000000000000000000000000000000000000000000000000000000000000000000111111111111
100000000000000000000000000000000000000000000000000000000000000000000000000000000000000000000000000000000000111111111111
100000000000000000000000000000000000000000000000000000000000000000000000000000000000000000000000000000000000111111111111
100000000000000000000000000000000000000000000000000000000000000000000000000000000000000000000000000000000000111111111111
100000000000000000000000000000000000000000000000000000000000000000000000000000000000000000000000000000000000111111111111
100000000000000000000000000000000000000000000000000000000000000000000000000000000000000000000000000000000000111111111111
100000000000000000000000000000000000000000000000000000000000000000000000000000000000000000000000000000000000111111111111
100000000000000000000000000000000000000000000000000000000000000000000000000000000000000000000000000000000000111111111111
100000000000000000000000000000000000000000000000000000000000000000000000000000000000000000000000000000000000111111111111
100000000000000000000000000000000000000000000000000000000000000000000000000000000000000000000000000000000000111111111111
100000000000000000000000000000000000000000000000000000000000000000000000000000000000000000000000000000000000111111111111
100000000000000000000000000000000000000000000000000000000000000000000000000000000000000000000000000000000000111111111111
100000000000000000000000000000000000000000000000000000000000000000000000000000000000000000000000000000000000111111111111
100000000000000000000000000000000000000000000000000000000000000000000000000000000000000000000000000000000000111111111111
100000000000000000000000000000000000000000000000000000000000000000000000000000000000000000000000000000000000111111111111
100000000000000000000000000000000000000000000000000000000000000000000000000000000000000000000000000000000000111111111111
100000000000000000000000000000000000000000000000000000000000000000000000000000000000000000000000000000000000111111111111
100000000000000000000000000000000000000000000000000000000000000000000000000000000000000000000000000000000000111111111111
100000000000000000000000000000000000000000000000000000000000000000000000000000000000000000000000000000000000111111111111
100000000000000000000000000000000000000000000000000000000000000000000000000000000000000000000000000000000000111111111111
100000000000000000000000000000000000000000000000000000000000000000000000000000000000000000000000000000000000111111111111
100000000000000000000000000000000000000000000000000000000000000000000000000000000000000000000000000000000000111111111111
100000000000000000000000000000000000000000000000000000000000000000000000000000000000000000000000000000000000111111111111
100000000000000000000000000000000000000000000000000000000000000000000000000000000000000000000000000000000000111111111111
100000000000000000000000000000000000000000000000000000000000000000000000000000000000000000000000000000000000111111111111
100000000000000000000000000000000000000000000000000000000000000000000000000000000000000000000000000000000000111111111111
100000000000000000000000000000000000000000000000000000000000000000000000000000000000000000000000000000000000111111111111
100000000000000000000000000000000000000000000000000000000000000000000000000000000000000000000000000000000000111111111111
100000000000000000000000000000000000000000000000000000000000000000000000000000000000000000000000000000000000111111111111
100000000000000000000000000000000000000000000000000000000000000000000000000000000000000000000000000000000000111111111111
100000000000000000000000000000000000000000000000000000000000000000000000000000000000000000000000000000000000111111111111
100000000000000000000000000000000000000000000000000000000000000000000000000000000000000000000000000000000000111111111111
100000000000000000000000000000000000000000000000000000000000000000000000000000000000000000000000000000000000111111111111
100000000000000000000000000000000000000000000000000000000000000000000000000000000000000000000000000000000000111111111111
100000000000000000000000000000000000000000000000000000000000000000000000000000000000000000000000000000000000111111111111
100000000000000000000000000000000000000000000000000000000000000000000000000000000000000000000000000000000000111111111111
100000000000000000000000000000000000000000000000000000000000000000000000000000000000000000000000000000000000111111111111
100000000000000000000000000000000000000000000000000000000000000000000000000000000000000000000000000000000000111111111111
100000000000000000000000000000000000000000000000000000000000000000000000000000000000000000000000000000000000111111111111
100000000000000000000000000000000000000000000000000000000000000000000000000000000000000000000000000000000000111111111111
100000000000000000000000000000000000000000000000000000000000000000000000000000000000000000000000000000000000111111111111
100000000000000000000000000000000000000000000000000000000000000000000000000000000000000000000000000000000000111111111111
100000000000000000000000000000000000000000000000000000000000000000000000000000000000000000000000000000000000111111111111
100000000000000000000000000000000000000000000000000000000000000000000000000000000000000000000000000000000000111111111111
100000000000000000000000000000000000000000000000000000000000000000000000000000000000000000000000000000000000111111111111
100000000000000000000000000000000000000000000000000000000000000000000000000000000000000000000000000000000000111111111111
100000000000000000000000000000000000000000000000000000000000000000000000000000000000000000000000000000000000111111111111
100000000000000000000000000000000000000000000000000000000000000000000000000000000000000000000000000000000000111111111111
100000000000000000000000000000000000000000000000000000000000000000000000000000000000000000000000000000000000111111111111
100000000000000000000000000000000000000000000000000000000000000000000000000000000000000000000000000000000000111111111111
100000000000000000000000000000000000000000000000000000000000000000000000000000000000000000000000000000000000111111111111
100000000000000000000000000000000000000000000000000000000000000000000000000000000000000000000000000000000000111111111111
100000000000000000000000000000000000000000000000000000000000000000000000000000000000000000000000000000000000111111111111
100000000000000000000000000000000000000000000000000000000000000000000000000000000000000000000000000000000000111111111111
100000000000000000000000000000000000000000000000000000000000000000000000000000000000000000000000000000000000111111111111
100000000000000000000000000000000000000000000000000000000000000000000000000000000000000000000000000000000000111111111111
100000000000000000000000000000000000000000000000000000000000000000000000000000000000000000000000000000000000111111111111
100000000000000000000000000000000000000000000000000000000000000000000000000000000000000000000000000000000000111111111111
100000000000000000000000000000000000000000000000000000000000000000000000000000000000000000000000000000000000111111111111
100000000000000000000000000000000000000000000000000000000000000000000000000000000000000000000000000000000000111111111111
100000000000000000000000000000000000000000000000000000000000000000000000000000000000000000000000000000000000111111111111
100000000000000000000000000000000000000000000000000000000000000000000000000000000000000000000000000000000000111111111111
100000000000000000000000000000000000000000000000000000000000000000000000000000000000000000000000000000000000111111111111
100000000000000000000000000000000000000000000000000000000000000000000000000000000000000000000000000000000000111111111111
100000000000000000000000000000000000000000000000000000000000000000000000000000000000000000000000000000000000111111111111
100000000000000000000000000000000000000000000000000000000000000000000000000000000000000000000000000000000000111111111111
100000000000000000000000000000000000000000000000000000000000000000000000000000000000000000000000000000000000111111111111
100000000000000000000000000000000000000000000000000000000000000000000000000000000000000000000000000000000000111111111111
100000000000000000000000000000000000000000000000000000000000000000000000000000000000000000000000000000000000111111111111
100000000000000000000000000000000000000000000000000000000000000000000000000000000000000000000000000000000000111111111111
100000000000000000000000000000000000000000000000000000000000000000000000000000000000000000000000000000000000111111111111
100000000000000000000000000000000000000000000000000000000000000000000000000000000000000000000000000000000000111111111111
100000000000000000000000000000000000000000000000000000000000000000000000000000000000000000000000000000000000111111111111
100000000000000000000000000000000000000000000000000000000000000000000000000000000000000000000000000000000000111111111111
100000000000000000000000000000000000000000000000000000000000000000000000000000000000000000000000000000000000111111111111
100000000000000000000000000000000000000000000000000000000000000000000000000000000000000000000000000000000000111111111111
100000000000000000000000000000000000000000000000000000000000000000000000000000000000000000000000000000000000111111111111
100000000000000000000000000000000000000000000000000000000000000000000000000000000000000000000000000000000000111111111111
100000000000000000000000000000000000000000000000000000000000000000000000000000000000000000000000000000000000111111111111
100000000000000000000000000000000000000000000000000000000000000000000000000000000000000000000000000000000000111111111111
100000000000000000000000000000000000000000000000000000000000000000000000000000000000000000000000000000000000111111111111
100000000000000000000000000000000000000000000000000000000000000000000000000000000000000000000000000000000000111111111111
100000000000000000000000000000000000000000000000000000000000000000000000000000000000000000000000000000000000111111111111
100000000000000000000000000000000000000000000000000000000000000000000000000000000000000000000000000000000000111111111111
100000000000000000000000000000000000000000000000000000000000000000000000000000000000000000000000000000000000111111111111
100000000000000000000000000000000000000000000000000000000000000000000000000000000000000000000000000000000000111111111111
100000000000000000000000000000000000000000000000000000000000000000000000000000000000000000000000000000000000111111111111
100000000000000000000000000000000000000000000000000000000000000000000000000000000000000000000000000000000000111111111111
100000000000000000000000000000000000000000000000000000000000000000000000000000000000000000000000000000000000111111111111
100000000000000000000000000000000000000000000000000000000000000000000000000000000000000000000000000000000000111111111111
100000000000000000000000000000000000000000000000000000000000000000000000000000000000000000000000000000000000111111111111
100000000000000000000000000000000000000000000000000000000000000000000000000000000000000000000000000000000000111111111111
100000000000000000000000000000000000000000000000000000000000000000000000000000000000000000000000000000000000111111111111
100000000000000000000000000000000000000000000000000000000000000000000000000000000000000000000000000000000000111111111111
100000000000000000000000000000000000000000000000000000000000000000000000000000000000000000000000000000000000111111111111
100000000000000000000000000000000000000000000000000000000000000000000000000000000000000000000000000000000000111111111111
100000000000000000000000000000000000000000000000000000000000000000000000000000000000000000000000000000000000111111111111
100000000000000000000000000000000000000000000000000000000000000000000000000000000000000000000000000000000000111111111111
100000000000000000000000000000000000000000000000000000000000000000000000000000000000000000000000000000000000111111111111
100000000000000000000000000000000000000000000000000000000000000000000000000000000000000000000000000000000000111111111111
100000000000000000000000000000000000000000000000000000000000000000000000000000000000000000000000000000000000111111111111
100000000000000000000000000000000000000000000000000000000000000000000000000000000000000000000000000000000000111111111111
100000000000000000000000000000000000000000000000000000000000000000000000000000000000000000000000000000000000111111111111
100000000000000000000000000000000000000000000000000000000000000000000000000000000000000000000000000000000000111111111111
100000000000000000000000000000000000000000000000000000000000000000000000000000000000000000000000000000000000111111111111
100000000000000000000000000000000000000000000000000000000000000000000000000000000000000000000000000000000000111111111111
100000000000000000000000000000000000000000000000000000000000000000000000000000000000000000000000000000000000111111111111
100000000000000000000000000000000000000000000000000000000000000000000000000000000000000000000000000000000000111111111111
100000000000000000000000000000000000000000000000000000000000000000000000000000000000000000000000000000000000111111111111
100000000000000000000000000000000000000000000000000000000000000000000000000000000000000000000000000000000000111111111111
100000000000000000000000000000000000000000000000000000000000000000000000000000000000000000000000000000000000111111111111
100000000000000000000000000000000000000000000000000000000000000000000000000000000000000000000000000000000000111111111111
100000000000000000000000000000000000000000000000000000000000000000000000000000000000000000000000000000000000111111111111
100000000000000000000000000000000000000000000000000000000000000000000000000000000000000000000000000000000000111111111111
100000000000000000000000000000000000000000000000000000000000000000000000000000000000000000000000000000000000111111111111
100000000000000000000000000000000000000000000000000000000000000000000000000000000000000000000000000000000000111111111111
100000000000000000000000000000000000000000000000000000000000000000000000000000000000000000000000000000000000111111111111
100000000000000000000000000000000000000000000000000000000000000000000000000000000000000000000000000000000000111111111111
100000000000000000000000000000000000000000000000000000000000000000000000000000000000000000000000000000000000111111111111
100000000000000000000000000000000000000000000000000000000000000000000000000000000000000000000000000000000000111111111111
100000000000000000000000000000000000000000000000000000000000000000000000000000000000000000000000000000000000111111111111
100000000000000000000000000000000000000000000000000000000000000000000000000000000000000000000000000000000000111111111111
100000000000000000000000000000000000000000000000000000000000000000000000000000000000000000000000000000000000111111111111
100000000000000000000000000000000000000000000000000000000000000000000000000000000000000000000000000000000000111111111111
100000000000000000000000000000000000000000000000000000000000000000000000000000000000000000000000000000000000111111111111
100000000000000000000000000000000000000000000000000000000000000000000000000000000000000000000000000000000000111111111111
100000000000000000000000000000000000000000000000000000000000000000000000000000000000000000000000000000000000111111111111
100000000000000000000000000000000000000000000000000000000000000000000000000000000000000000000000000000000000111111111111
100000000000000000000000000000000000000000000000000000000000000000000000000000000000000000000000000000000000111111111111
100000000000000000000000000000000000000000000000000000000000000000000000000000000000000000000000000000000000111111111111
100000000000000000000000000000000000000000000000000000000000000000000000000000000000000000000000000000000000111111111111
100000000000000000000000000000000000000000000000000000000000000000000000000000000000000000000000000000000000111111111111
100000000000000000000000000000000000000000000000000000000000000000000000000000000000000000000000000000000000111111111111
100000000000000000000000000000000000000000000000000000000000000000000000000000000000000000000000000000000000111111111111
100000000000000000000000000000000000000000000000000000000000000000000000000000000000000000000000000000000000111111111111
10000000000000000000000000000000000000000S000000000000000000000000000000000000000000000000000000000000000000111111111111
100000000000000000000000000000000000000000000000000000000000000000000000000000000000000000000000000000000000111111111111
100000000000000000000000000000000000000000000000000000000000000000000000000000000000000000000000000000000000111111111111
100000000000000000000000000000000000000000000000000000000000000000000000000000000000000000000000000000000000111111111111
100000000000000000000000000000000000000000000000000000000000000000000000000000000000000000000000000000000000111111111111
100000000000000000000000000000000000000000000000000000000000000000000000000000000000000000000000000000000000111111111111
100000000000000000000000000000000000000000000000000000000000000000000000000000000000000000000000000000000000111111111111
100000000000000000000000000000000000000000000000000000000000000000000000000000000000000000000000000000000000111111111111
100000000000000000000000000000000000000000000000000000000000000000000000000000000000000000000000000000000000111111111111
100000000000000000000000000000000000000000000000000000000000000000000000000000000000000000000000000000000000111111111111
100000000000000000000000000000000000000000000000000000000000000000000000000000000000000000000000000000000000111111111111
100000000000000000000000000000000000000000000000000000000000000000000000000000000000000000000000000000000000111111111111
100000000000000000000000000000000000000000000000000000000000000000000000000000000000000000000000000000000000111111111111
100000000000000000000000000000000000000000000000000000000000000000000000000000000000000000000000000000000000111111111111
100000000000000000000000000000000000000000000000000000000000000000000000000000000000000000000000000000000000111111111111
100000000000000000000000000000000000000000000000000000000000000000000000000000000000000000000000000000000000111111111111
100000000000000000000000000000000000000000000000000000000000000000000000000000000000000000000000000000000000111111111111
100000000000000000000000000000000000000000000000000000000000000000000000000000000000000000000000000000000000111111111111
100000000000000000000000000000000000000000000000000000000000000000000000000000000000000000000000000000000000111111111111
100000000000000000000000000000000000000000000000000000000000000000000000000000000000000000000000000000000000111111111111
100000000000000000000000000000000000000000000000000000000000000000000000000000000000000000000000000000000000111111111111
100000000000000000000000000000000000000000000000000000000000000000000000000000000000000000000000000000000000111111111111
100000000000000000000000000000000000000000000000000000000000000000000000000000000000000000000000000000000000111111111111
100000000000000000000000000000000000000000000000000000000000000000000000000000000000000000000000000000000000111111111111
100000000000000000000000000000000000000000000000000000000000000000000000000000000000000000000000000000000000111111111111
100000000000000000000000000000000000000000000000000000000000000000000000000000000000000000000000000000000000111111111111
100000000000000000000000000000000000000000000000000000000000000000000000000000000000000000000000000000000000111111111111
100000000000000000000000000000000000000000000000000000000000000000000000000000000000000000000000000000000000111111111111
100000000000000000000000000000000000000000000000000000000000000000000000000000000000000000000000000000000000111111111111
100000000000000000000000000000000000000000000000000000000000000000000000000000000000000000000000000000000000111111111111
100000000000000000000000000000000000000000000000000000000000000000000000000000000000000000000000000000000000111111111111
100000000000000000000000000000000000000000000000000000000000000000000000000000000000000000000000000000000000111111111111
100000000000000000000000000000000000000000000000000000000000000000000000000000000000000000000000000000000000111111111111
100000000000000000000000000000000000000000000000000000000000000000000000000000000000000000000000000000000000111111111111
100000000000000000000000000000000000000000000000000000000000000000000000000000000000000000000000000000000000111111111111
100000000000000000000000000000000000000000000000000000000000000000000000000000000000000000000000000000000000111111111111
100000000000000000000000000000000000000000000000000000000000000000000000000000000000000000000000000000000000111111111111
100000000000000000000000000000000000000000000000000000000000000000000000000000000000000000000000000000000000111111111111
100000000000000000000000000000000000000000000000000000000000000000000000000000000000000000000000000000000000111111111111
100000000000000000000000000000000000000000000000000000000000000000000000000000000000000000000000000000000000111111111111
1111111111111111111111111111111111111111111111111111111111111111111111111111111111111111111111111111111111111
